X: 25
Y: 25
A*
false
C:\Users\Dieter\Documents\GitHub\Java-Pathfinder-Simulator\niels.maze
2000000000000000000000000
0110010101110100011000000
0111010001000100100000000
0101010101000100100000000
0101110101100100111000000
0100110101000100001000000
0100110101000100001000000
0100010101110110111000000
0000000000000000000000000
0000000000000000000000000
0000000011111000000000000
0000000000000000000000000
0000000000000000000000000
0000000011111000000000000
0000000000000000000000000
0000000000000000000000000
0011100100110100100000000
0010010001000101100000000
0010010101000111000000000
0010010101000101000000000
0010010101000101100000000
0011100100110100100000000
0000000000000000000000000
0000000000000000000000000
0000000000000000000000003
