X: 20
Y: 20
Dijkstra
true
F:\Users\Dieter Balemans\Desktop\cirkels.maze
21111111111111111111
00000000000000000000
01111111111111111110
01000000000000000010
01001111111111111010
01010000000000001010
01010111111111101010
01010100000000101010
01010100111110101010
01010101000010101010
01010101000310101010
01010101111110101010
01010100000000101010
01010111111111001010
01010000000000001010
01011111111111111010
01000000000000000010
01111111111111111100
00000000000000000000
11111111111111111111
