X: 20
Y: 20
A*
true
D:\Users\Niels\workspace\Java-Pathfinder-Simulator\presets\diagonal_test.maze
21101110111011101111
01010101010101010111
01010101010101010111
01010101010101010111
01010101010101010111
01010101010101010111
01010101010101010111
01010101010101010111
01010101010101010111
01010101010101010111
01010101010101010111
01010101010101010111
01010101010101010111
01010101010101010111
01010101010101010111
01010101010101010111
01010101010101010111
01010101010101010111
01010101010101010101
10111011101110111013
