X: 99
Y: 99
Breadth-first search
false
D:\Users\Niels\Desktop\huge.maze
010010110111011001010000110101100110010000000100010100011101001011001011010111101000110000001011100
110101010100010111010010011101101001001011000110101110010100010010000111101111010001001111100011011
101101001000111100111110000000111001100001110111110010010011001001011001110110011000011101100111101
001010110011111011111101101101010000101110101000011110010110110111011101100110010101110011100001100
110110100001111011000010001001001100000010111101000001111011100000010111010010000011000010000010011
110101001010001000010101111100001110110010101100100111001010011100011011001100101001001111110001010
011100000001101010001111000000010111011111110111010111010010010000011011110001110010000000000110000
101110110101010011101101011001011001011110100010101000000011010100010010101000010111101110000111110
110110011100000101000111001010001000101101111001100110000001110001110101101000001010010100111011000
010001001111101011001101110010011000100010101100110101110110001101110100110100000010000001100100111
100011010011101101011111101100011011001001010011001000100100010100000000111011011010000001001011111
110010001110011010101000101101010111101100100110110001001001011001111011101110001001110111111011111
011101001011010110100110000001000001001111101100010011100101001010001110101100001111001001111110111
011001001101101101101000011111000011011000000011100110001100111010101110100001101011010001011100111
011101100101000011101001011111011000000111100101111010000011011111001111010011100011110101110011010
101100011001111001100101111110011010101100100110100010011001101100100000001010010000001011011110001
111111101001110100000010000001100100110110110011101001001111100111010101101010111101100101110011110
001101011001011101111001010001111110100010011101000011000000010001100110010000011101010100101001100
000100000100001100000111011110011010001101111001100000100011010000100100110101111111100110110001011
000010010010101000110111000001011101001101110001111011101100001011101100000001010111001011101000011
110111111101111010101101010010111011011100111010001110100110100000011010111010100000010110010110000
100001100100110110101100001101100111000111001100110001101101111001000001100011101101100101001100000
011010011001111001011010110111111110000100000010001010100100010110011000000101100111001000011101100
111110101101101011111110010110000001011000011101110111000010101111101000010111101111110000010111010
111100101100110111000011100011100011000101100101010010010111100001101010101010000010101110111010000
110110000001110001011000110110111111100011100101101000100100011110000100000010011001101000011001101
111001100100101110101100010111101101101111110010100110010100011100111101011110000010001011010101110
000110100101010111111001101111000011110111011110100000110000110001001010110010110000110000101000101
010001011011010111010001111001000000010000000010001110100111001001101110111001000011101010000000100
001010110010110000100011100111101110110101001001001010001010110101011111111011110110011111101100110
100110101001010111011110011110111110001101101111000011000011000110100101011101000110100011010001010
001100000011010101110100001111000101010101101110001100020000111100010000100001001010111110110101101
100101000011110100101010110001000011110101001011011001100010001001011111111011000001001011010110011
000011010100101001100010100100100000000111100001011111001000011000111000111100101011000110111010100
001111101000111111100001101001110111011010011101011001011010101001000110111011100110000100001111111
101110111010001111011101011110100100101111110010101100000110100110000101100010000101101010001110101
001001001011111000100110010010001110011010011111011110110110000011110001011100001010011010101011001
100101101101001001010110011101111111111010111010111011011100101001010011000101101011001101011011011
110101011001000110100100111110100011000001111101011010010101101001100000110101110001001000101111011
110011110110111110010010110100110000010010101110111010111010110110101011011101111001110110010001010
001001101111000100100000000110011010000110001010010011110100111111101010110101100101010111001100001
001001110101000110100111011010101011010000110000111110011100110111110100011000100110001110000101110
111010101000001110111001010110100011110011110000100101001011000111001100101011000110111110011100010
111100000010111110010100000011010001110100000101111010000000011111001110001001010111111010001010010
000000010101100001100111011001100111011101011110011110010111100100100110000010101101010000001110011
010100110001101011101010000010000101101010100100110111100100100111000010001100000001111010001001111
101000001111000111101111110010110111101111101010110100010000101010000010110001111100101001100110100
100110011110001110101001101100110111110110101110111110010111010000000100101100000011111010000100000
011101100001100000100001011110010001110110110011011011101000001101111100010011001111000011111000010
000001111011111010011001100000100011000101001001110110111111101000000110000010001000011110000101101
010000110011011011110011100101001001100000111101101010100011000001110110001100111111100000100101111
001111111110001001111010111010111110111111011011100110000010101000001111011000100110101111110011110
110111000010110001101110100011101111101011011101101000111101001100101101010011101010100000100011001
001010100100111100110011000010101000101110011101100111010000000011010110001010110001011011000010111
101000101000110111011101010110000111111010000101011110100000010000000000010111010101110100000011110
100000011110111110100000001110000010010110011000101110100110011011100001111100110010001000111110100
100010100011000011101101000101000000011101101101101110001101010110100101101000100001010101011111011
010011110100100100000111111101000110000011111011111000110101001100101001101010111101011000101000000
101011110011000010101100111000101110101110110010100000111001010011100001011110001101001001111010011
110010110001001110101111100000111010000101000001111110101011100100101101110110000011101010000011011
100111110010000001110001101000001101010111001101110000100010101010101011000111010001100111100001100
100001110111010000001100000101111010111001000011010000010101011011110001111000010111000111100010111
110011110111101100101000100001001010011110010101111010000000000001111010011010111100001100110101100
111111010110101010001011011011100000111001100010110111001101000011000000001100010011110001001010000
101110111111110011101101110111001000111100101101100011111001101000011000010010111010011010101001000
011111010101100001110000001001100000110011011100001011011010011100110010100000001110100000011001100
000010001001100001010000111111001101110010110010001111101001101010000101111011010111001111100110110
000100101111010010010100011100001011111010110010111010111011001001100101000011110101010011101011100
110010001101100010001111001000111111011011001101011110010100101101110101011010001111001110011110111
101010101011001000111011001000101001111011011001110110000001011110010100000111001110110101101011001
101110101100100011001011001000011010010010111100101000001001101100110110111011111100110001100100111
010110101100011111000110111101010010000111111000111001101111111111100000000100010010010101001111101
100000001010010101100001010111011011100011111001011000101101100100011010110000100001100111010000000
100010111010101011101100101011100010011101110110111011011001110100101011111000010000000011110110000
100010011010000100011110111010111010010100110000110011010110111010101010000100010101011110110010010
011111101110110001101101101111000101000100000001101011010011111110011100011000100011101111101101110
100011110011110001010111010011011110111010001011100000010110110111000101110100000000001100100100110
110111101001011110101110110111100001100111010101010011010000111111111011110000000000101111101011101
111011011111111111001110010011110110100101110111011101110101011001010110010100300101111011101101011
100010001110101111000111110000001001010110000011101010100010101111011001111011001101011111100011111
111100010111111111111101011000110011011100010011001101010110011011110001011011010000111110001101000
101011010001011010100100100010110001011000110001110010100100101110000110110011110000110110111001001
111001001110101110000001001000011101010100101000101101110010110101001011001111111101101100010010001
100111111101111101101110000100011000001010100100110011101001101100100001100100110110011001000111011
011001011011110010011100011100011001000000010110111000001011111011111111001101101011100011110010101
110000110111110101100011010101100010110001101110011111111000011100000111100111100000001101110101011
101001000111001100110010101011100011111101110101010111101101011111101101011100011010001101010111111
011111001111001000001100101011010101000000011001111000110001001101110011110010100101101110100110000
110010000101100010000010111000001100010110101101011101001011010001110010100001000101110010011010111
110010100110001000000101110010101000010011111010100000001000100110100011101001101100100010111101110
101001011100100000100010001001000000100001100011101011001001001001111001110100011000010010000101000
001100100011000001010001100100111001100011001001011001100101111100010000001001100011110111000111010
100010001000101001101000100111111111110101111000100111011101000111110001011110001101101101100110010
101101111110100001101110110010000100011011011100010001111100100111000011001010101100010001100110001
000011101001110000001111111111111110100011110001110111000101110100110001001110010100101100001101111
000110101000000010101011111011111001001000111010010100111100011110001110111100100000010011100001001
010001010111011011111010001010101000111011100110001101000111100010101000011001001010111010101011111
011000111011111100000111000011001110001001011011010000000010001100101011010100001011101000010100101
001101110011001010110010010011011100100000100010001100100110000111011001000111010000100100100110110
