X: 20
Y: 20
Breadth-first search
false
D:\Users\Niels\workspace\Java-Pathfinder-Simulator\presets\maze.maze
20000100111111000100
11110110100000010110
00010110111011110000
11010110000010000111
00000000111111111101
01111110000000000001
00000110110111111011
11110000110110001011
10000111100000101000
10111110001110101110
10000000101110100000
11111110100010111111
00010000101010000001
01010111101011101111
01010111101011101000
01110000001000001010
00000101111111111010
11111100000000000010
00000001110110111111
11111111000110000003
