X: 25
Y: 25
A*
false
D:\Users\Niels\workspace\Java-Pathfinder-Simulator\niels.maze
2000000000000000000000000
0110010101110100011000000
0111010001000100100000000
0101010101000100100000000
0101110101100100111000000
0100110101000100001000000
0100110101000100001000000
0100010101110110111000000
0000000000000000000000000
0000000000000000000000000
0000000011111000000000000
0000000000000000000000000
0000000000000000000000000
0000000011111000000000000
0000000000000000000000000
0000000000000000000100000
0011100111100011100100000
0010001101100010110100000
0010001001000010010100000
0010001101000011110100000
0010000111000000000111000
0011100000000000000000000
0000000000000000000000000
0000000000000000000000000
0000000000000000000000003
