X: 21
Y: 21
A*
true
D:\Users\Niels\workspace\Java-Pathfinder-Simulator\presets\perfect_example.maze
000000000010000000000
000000000010000000000
000000000010000000000
000000000010000000000
000000000010000000000
000002000010000000000
000000000010000000000
000000000010000000000
000000000010000000000
000000000010000000000
111111111101111111111
000000000010000000000
000000000010000000000
000000000010000000000
000000000010000000000
000000000010000300000
000000000010000000000
000000000010000000000
000000000010000000000
000000000010000000000
000000000010000000000
