X: 19
Y: 19
Breadth-first search
false
D:\Users\Niels\workspace\Java-Pathfinder-Simulator\presets\smiley.maze
0000000000000000000
0000000000000000000
0000000111110000000
0000011111111100000
0000111111111110000
0001111111111111000
0001110011100111000
0011110011100111100
0011111111111111100
0011111111111111100
0011111111111111100
0011201111111031100
0001100111110011000
0001110000000111000
0000111111111110000
0000011111111100000
0000000111110000000
0000000000000000000
0000000000000000000
