X: 20
Y: 20
Dijkstra
true
D:\Users\Niels\workspace\Java-Pathfinder-Simulator\smiley.maze
00000000000000000000
00000000000000000000
00000000000000000000
00001110000011100000
00011011000110110000
00012001000100010000
00010001000100310000
00011111000111110000
00000000000000000000
00000000000000000000
00000000000000000000
11100000000000000111
01000000000000000010
01000000000000000010
01000000000000000010
01100000000000000110
00110000000000001100
00011111111111111000
00000000000000000000
00000000000000000000
