X: 20
Y: 20
Breadth-first search
false
D:\Users\Niels\workspace\Java-Pathfinder-Simulator\test.maze
11111111111111111111
11111111111111111111
11111111111111111111
11111000111100011111
11110010111101001111
11110110111101101111
11110110111101101111
11110000111100001111
11111111111111111111
11111111111111111111
11111111111111111111
11111111111111111111
11211111111111111311
11011111111111111011
11000111111111100011
11110011111111001111
11111000000000011111
11111111111111111111
11111111111111111111
11111111111111111111
